5 7
##E####
##.####
##.####
##...r#
#######