5 5
#####
#...#
#.#E#
#r..#
#####