7 10
##########
#........#
#.######.#
#.#....#E#
#.#.##.#.#
#r#....#.#
##########