5 7
#######
#r....#
#..B..#
#..E..#
#######
