10 15
###############
#r........#...#
###.#####.#.#.#
#...#.....#.#.#
#.#####.#####.#
#.#.....#.....#
#.#.#####.###E#
#.#.#.....#...#
#...#.....#####
###############