10 20
####################
#r.......#.........#
#######..#######...#
#.......#.......#.##
#..#######..####..##
#..#............#.##
#..####..#######..##
#.......#E.......###
####################